ZZZZZZZZZZZZZZZZZZZZZZZZZZZZZZ
Z5555555555555555555555555555Z
Z5555555555555555555555555555Z
Z5555555555555555555555555555Z
Z5555555555555555555555555555Z
Z5555551155555555555555555555Z
Z55777111B6666665555566655555Z
Z5577711111666666555666655555Z
Z5555511116666666556666655555Z
Z55555B1622222222522266655555Z
Z55555666V2222332823266655555Z
Z5555566622222332523266655555Z
Z5555566622222225522266655555Z
Z5555566622222255552266655555Z
Z5555566622222552555266655555Z
Z5555566622225522255566655555Z
Z5555566622225522225556655555Z
Z5555566622255222222555655555Z
Z5555566625552222222255555555Z
Z5555566555222222222266555555Z
Z5555555566666666666666655555Z
Z5555556666666666666666655555Z
Z5555566666666666666666655555Z
Z5555555555555555555555555555Z
Z5555555555555555555555555555Z
Z5555555555555555555555555555Z
Z5555555555555555555555555555Z
Z5555555555555555555555555555Z
Z5555555555555555555555555555Z
ZZZZZZZZZZZZZZZZZZZZZZZZZZZZZZ